The first line is for instructions, make a 2D array, 0 = empty space, 1 = solid block, 2 = spawn point, 3 = end point, 4 = wood block |
1,1,1,1,1,1,1,1,1,1,1,1,1,1,1,1,1,1,1,1,1,1,1,1,1,1,1,1,1,1,1,1|
1,1,1,1,1,1,1,1,1,1,1,1,0,4,0,0,0,0,2,0,0,1,1,1,1,1,1,1,1,1,1,1|
1,1,1,1,1,1,1,1,1,1,1,0,0,1,4,4,4,4,4,4,4,1,1,1,1,1,1,1,1,1,1,1|
1,1,1,1,1,1,1,1,1,1,1,0,1,1,0,0,0,0,0,0,0,1,1,1,1,1,1,1,1,1,1,1|
1,1,1,1,1,1,1,1,1,1,1,0,1,1,1,0,1,0,1,0,1,1,1,1,1,1,1,1,1,1,1,1|
1,1,1,1,4,4,1,1,1,1,1,0,1,1,0,0,0,0,0,0,0,1,1,1,1,1,4,4,1,1,1,1|
1,1,1,1,4,4,1,1,1,1,0,0,1,1,0,1,0,1,0,1,0,1,1,1,1,1,4,4,1,1,1,1|
1,1,4,4,4,4,4,4,1,1,0,1,1,1,0,0,0,0,0,0,0,1,1,1,4,4,1,1,4,4,1,1|
1,1,4,4,4,4,4,4,1,1,0,1,1,1,0,0,1,0,1,0,0,1,1,1,4,4,1,1,4,4,1,1|
1,1,1,1,4,4,1,1,1,1,0,1,1,1,0,0,0,0,0,0,0,1,1,1,1,1,4,4,1,1,1,1|
1,1,1,1,4,4,1,1,1,1,0,0,1,1,0,0,0,0,0,0,0,1,1,1,1,1,4,4,1,1,1,1|
1,1,1,1,1,1,1,1,1,1,1,0,1,1,0,1,0,1,0,1,0,1,1,1,1,1,1,1,1,1,1,1|
1,1,1,1,1,1,1,1,1,1,1,0,1,1,0,1,0,1,0,1,0,1,1,1,1,1,1,1,1,1,1,1|
1,1,1,1,1,1,1,1,1,1,1,0,1,1,0,1,0,1,0,1,0,1,1,1,1,1,1,1,1,1,1,1|
1,1,1,1,1,1,1,1,1,1,1,0,0,0,0,0,0,0,0,1,3,1,1,1,1,1,1,1,1,1,1,1|
1,1,1,1,1,1,1,1,1,1,1,1,1,1,1,1,1,1,1,1,1,1,1,1,1,1,1,1,1,1,1,1|
The following lines are for what and how many spells etc. For true or false options 0 = false and 1 = true|
Ice Spell?, 1|
How many uses?, 3|
Fire Spell?, 1|
How many uses?, 3|
Wind Spell?, 1|
How many uses?, 6|
